------------------------------------------------------------------------------------------------------------------------
------------------------------------------------------------------------------------------------------------------------
------------------------------------------------------------------------------------------------------------------------
------------------------------?????------------------------------e---------------------------------------o-----e-----e--
-e-----------e---------#BB---------------------------------------------------------------------------e------------e-----
-e-------------------------------------e--------------------------------------------------------------------------------
-------------------------------e---------------------------------------------------------------------------------e------
------------------------------------------------------------------------------------------------------------------------
----------##-------e##---------------#--##-------------------------#----------------------------------------------------
-----------------#-------------------------------------------------------pP---------------------------------------e-----
----pP--------------------------------------------------#######-###########-###--#----------------------------------####
###-PP------------------########------------------####-#-#-#####----------------------------######-------###-----?-----#
----PP------pP--------------------------pP-------------pP---------------##--##-----##-----------###---------------------
#---#####################----###------#####---########################---####---####--##---#######-----#################