------------------------------------------------------------------------------------------------------------------------
------------------------------------------------------------------------------------------------------------------------
---------------------e--------------------------------------------------------------------------------------------------
------------------------------------------------------------------------------------------------------------------------
------------------------------------------------------------------------------------------------------------------------
------------------------------------------------------------------------------------------------------------------------
---------------------------------------------------------------------------?--------------------------------------------
------------------------------?S?---------------------------------------------------------------------------------------
----------e-----------------------------------------------------------------#-------------------------------------------
----------------------------------------------------------------------------#-------------------------------------------
----------------------------------------------------------------------------#-------------------------------------------
B?B--------?----------------------------------------------------------------#-------------------------------------------
---BBBBB--------------------------------------------------------------------#-------------------------------------------
#----##################----###------###---######################---###---####--##---#######-----#################--#####