------------------------------------------------------------------------------------------------------------------------
------------------------------------------------------------------------------------------------------------------------
------------------------------------------------------------------------------------------------------------------------
------------------------------------------------------------------------------------------------------------------------
---------------------------------------------------------------------------------------------------------###------------
-----------------------------------------------------------###------------###--------------BBB-----------###------------
------------------------------------------------------oo---###------------###----------------------------###------------
---------------------------------------oooo----------------###------------###----------------------------###---##-------
-----------###---------------------------------------------###------------###-----------------?----------###---##-------
-----------###---------------------------------------------###------------###----------------B-B---------###---##-------
-----------###---------------------------------------------###------------###--?--------------?BBB-------###---##-------
---?????---###--------?BBBBBBB?----pP-----------------BBBBBB##------------BBBB---------------------------###---##?------
-----------###BBB----B-B--B?B------PP----------------------###-----------####----------------------------###---##-------
#----##################----###-----####---######################---###---####--##---#######-----#################--#####