--------------------------------------------------------------------------------------------------------------------------------------------------------------------------------------------
--------------------------------------------------------------------------------------------------------------------------------------------------------------------------------------------
--------------------------------------------------------------------------------------------------------------------------------------------------------------------------------------------
--------------------------------------------------------------------------------------------------------------------------------------------------------------------------------------------
---------------?---------------------------------------------------------------------------------------------------------------------------------------------------------------------##-----
------------------------------------------------------------------------------------------------------------------------------------------------------------------------------------###-----
-----------------------------------------------------------------------------------------------------------------------------------------------------------------------------------####-----
----------------------------------------------------------------------------------------------------------------------------------------------------------------------------------#####-----
---------?---B?B?B--------------------------------------------------------------------------------------------------------------------------#------------------BB?B------------######-------
-------------------------------------------------------------------------------------------------------------------------------------------##--------------------------------#######--------
---------------------pP------------------pP-------------------------------------------------------------------------------------------------###----------pPpP--------------pP-########-----------
--------------e------pP-----------ee-----pP---------------------------------------------------e------------#------------------pPee-----###---###----ee----pPpP--------ee----pP#########-----------
############################################################################################################################################################################################