--------------------------------------------------------------------------------------------------------------------------------------------------------------------------------------------
--------------------------------------------------------------------------------------------------------------------------------------------------------------------------------------------
--------------------------------------------------------------------------------------------------------------------------------------------------------------------------------------------
------------------------------------------------------------------------------------------------------------e-------------------------------------------------------------------------------
---------------?----------------------------------------------------------------------------?B--------B?--B-BB----??BB----BB?B-------------------------------------------------------##-----
------------------------------------------------------------------------------------------------------------------------------------------------------------------------------------###-----
-----------------------------------------------------------------------------------------------------------------------------------------------------------------------------------####-----
----------------------------------------------------------------------------------------------------------------------------------------------------------------------------------#####-----
-------------BBB?B----------------------------------------------------?-----------------------------??-----?----eB--------B---------##-------###---------------BB?B------------######-------
--------------pP-------------pP-------------------------------##--------pP------------------------pP-----------pP----------#--------#---###-------##------------------------------#######--------
------pP------pP-------pP------------------------------------###---------pP-----------------------##--------------------##-------###--###-------##----pP-----pP--------------pP-########-----------
------pPe-----pPe------pP------------------------------------###--------------ee--------pPe------##ee----------ee-------##e------###---###------#e---pPpP-----pP--------ee----pP#########-----------
############################################################################################################################################################################################