--------------------------------------------------------------------------------------------------------------------------------------------------------------------------------------------
--------------------------------------------------------------------------------------------------------------------------------------------------------------------------------------------
--------------------------------------------------------------------------------------------------------------------------------------------------------------------------------------------
--------------------------------------------------------------------------------------------------------------------------------------------------------------------------------------------
------------------------------------------------------------------------------------------------------------------------BBB---------------------------------------BBBB--------------##------
------------------------------------------------------------------------------------------------------------------------------------------------------------------------------------#-------
--------------------------------------------------------------------------------------------------------------------------------------------------------------------------------------------
--------------------------------------------------------------------------------------------------------------------------------------------------------------------------------------------
-------------####---------------------------------------------------------------------------------------------------------------------------------------------------------------------------
-------------##-----------------------------------------------------------------------------------------------------------------------------------------------------------------------------
-----------###------------------------------------------------------------##--###-----------------------------------------------------------------------------------------------------------
--------#####-----------------------------------------------------------#########-#-------######---------------------------------------------------------------------------------#----------
############################################################################################################################################################################################