--------------------------------------------------------------------------------------------------------------------------------------------------------------------------------
--------------------------------------------------------------------------------------------------------------------------------------------------------------------------------
------------------------------------------------------------------------------------------------------------------------------------------------?-------------------------------
----------------------------------------------------------------------------------------------------------------------------------------------------------------------------|---
--------------------------------------------------------------------------------e-------------------------------------------------------------------------------------------|---
--------------------?BB-----------------------------------------------------BBBBBB----?----------------------------------------BBBBB------------------------------##--------|---
--------------------------------------------------------------------------------------------------------------------------------------------------BB------------e###--------|---
---------------------------------------------------------c---------------------------------------------------------------------------------------------#--------####--------|---
---------------------------------------------------------c-------------------e--------------------------------------------------e-------------BB------##-------#####--------|---
--------------------------------????-------------------BB#?B---------e-----BBBBBBB----e---------------e------------------------BBBBB-----------------###------######--------|---
-----------------e---c-----------------c-----e---c-------------------pP---------------pP--------------pP----e------------e------------#----c--------####-----#######--------|---
------------c--------c-------c--e------c---------c-----------c-------pP---------------pP---------c----pP----pP-----c-----pP-----------#----c----y--#####----########--------|---
------------c--------c-------c---------c---------c-----------c-------pP---------------pP---------c----pP-e--pP-----c-----pP------e----#----c----y-######---#########--------#---
##################################################################--#############################################################################-##############################
