------------------------------------------------------------------------------------------------------------------------------------------------------------------------------------------------------
------------------------------------------------------------------------------------------------------------------------------------------------------------------------------------------------------
------------------------------------------------------------------------------------------------------------------------------------------------------------------------------------------------------
--------------------------------------------------------------------------------------------------------------------------------------------------------------------------------------------------|---
--------------------------------------------------------------------------------------------------------------------------------------------------------------------------------------------------|---
-------------------------------------------------------------------------------------B?B------------------------------------------------------------------------------------------------##--------|---
-------------------------------------------------------------------------------------------------------------------------------------------------------e--------------------------------##--------|---
-------------------------------------------------------------------------------------------------------------------------------------------------------pP-------------------------------##--------|---
-------------------------------------------------------------------------------------------------------------------------------------------------------pP----------------------------#--##--------|---
---------------------------------------e------e-------------------------------------#####-----------------------------------------------------#?BB-----##---------------------------##--##--------|---
---------------------------------------pP-----pP----e--------------------------e----#--------------------------#------------------------------#---------------e------------e----e--###--##--------|---
---------------------------------------pP-----pP------------------------------------#---------------------c----#------------------------------#-----------c---pP-----c------------####------------|---
----------e--e-ee-------ee-e-----e-----pP-----pP-----------eee------ee-e------------#-------------ee-e----c----#---ee-e--e------e----------e-e#-----------c---pP-----c-----------#####------------#---
############################################--#########################################----##################--####################################---################################################