-----------------------------------------------------------------------------------------------------------------------------------------------------------------------------------------------------------------------
-----------------------------------------------------------------------------------------------------------------------------------------------------------------------------------------------------------------------
------------------e----------------------------------------------------------------------------------------------------------------------------------------------------------------------------------------------------
----------------e--------------------------------------------------------------------------------------------------------------------------------------------------------------------------------------------------|---
-------------------------------------------------------------------------------------------------------------------------------------------------------------------------------------------------------------------|---
-------------------##-----------------B?BBBBBBBBBBBBBBBBBBBBBBBBBBBBBBB------------------------------------------------------------------------------------------------------------------------------e---##--------|---
------------------###------------------------------------------------------------------------------------------------------------------------------------------------------------------------------------##--------|---
-----------------####------------------------------------------------------------------------------------------------------------------------------------------------------------------------------------##--------|---
-----------------####---------------------------------------------------------------------------------------------e------------------------------------e----------------------------e#----------------#--##--------|---
---------------#-####---????---------------------e-------------e--------BB--------------------B?---------BB------B#?-----------------------------------pP---------e-----e-----------##----------------#--##--------|---
----------e---##-####--------------------------------------e----------------------------ce------------------------------c-----e------e---e-------------pP-----e--------------------###----c---------#-#--##--------|---
-------------###-####------------------y----------------------------------------c----e--c-----------c-------------------c-----pP---------pP------------pP-----pP-----e----c------e####----c--------##-#--##--------|---
------------####-####------------------y----------------------------------------c-------c-----------c--e------c--e-e----c-----pP---------pP------------pP-----pP----------c------#####-e--c-------###-#--##--------#---
##########-#####-##############-########-####-#-###-######-##############--####-#####################################################-#####-#-#------####################-#---#######################-#--##############