-------------------------------------------------------------------------------------------------------------------------------------------------------------------------------------------------------
-------------------------------------------------------------------------------------------------------------------------------------------------------------------------------------------------------
-------------------------------------------------------------------------------------------------------------------------------------------------------------------------------------------------------
---------------------------------------------------------------------------------------------------------------------------------------------------------------------------------------------------|---
----------------???--------------------------------------------------------------oo--------------------------------e-----------------------------------e---------------oo--------------------------|---
------------------------BBBBB?--------------------------------------------------?BB------------------------------BBBBBBB?---------------------------BBBBB--------------BBBB--------------##--------|---
-------------------------------------------------------------------------------------------------------------------------------------------------------------------------------------e--###--------|---
------------c---------------------------------------------------##----------------------------------------------------------------------------------------------------------------------###--------|---
------------c-----------ooo------------------------------------###------------------BBB-------------------------------e---------------------------------------------------------------#-###--------|---
----------####----------BBBBBB------------##------e---------#--###-------?????-?--------------------e------------BBBBBBBB---------------------BBB------------------?-----------------##-###--------|---
---------##----------------------e------e###------pP------e##--###-----------e--------------------------------e-------------#----------------------------------ee-------e------------##-###--------|---
--------###---------y-------------------#####-----pP------###--###------------------------------------c-------pP------------#-----------??------------------------------pP---------#-##-###--------|---
-------####----e----y------------------######-----pP---e-####--###------------------oo----------------c-------pP------------#----eee-----------------ee-----------------pP--------##-##-###--------#---
#####################---#####################################--########################----###############################--###############-------###################---##--########-##-###############