-----------------------------------------------------------------------------------------------------------------------------------------------------------------------------------------------------
-----------------------------------------------------------------------------------------------------------------------------------------------------------------------------------------------------
---------------------------------------------------------------------------------------------------------------------------------------------------------------------------------------##------------
---------------------------------------------------------------------------------------------------------------------------------------------------------------------------------------##--------|---
---------------------------------------------------------------------------------------------------------------------------------------------------------------------------------------##--------|---
---------------------?BBB---------------------?????-----------?BBB--------BB?BB------BBBB-----------------------------?BBB------------------------------------BBBBB---?----------------##--------|---
---------------------------------------------------------------------------------------------------------------------------------------------------------------------------------------##--------|---
---------------------------------------------------------------------------------------------------------------------------e-----------------------------------------------------------##--------|---
-----------------#---------------------e---------------------------e----------------------------e------------------e-------pP----------------------------------------------------------##--------|---
--------B?B----e##---?-----#-----------pP----e?????----------B-----pP---????--???---------------pP-----------------pP--e---pP-----------------------------?---e-----?----e--------BB---##--------|---
---------------###---------#-----------pP--------------------------pP---------------------------pP----------e------pP--pP--pP----------------------#---------------e-----pP------------##--------|---
--------------####---------##----------pP--------------------------pP---------------------------pP----------pP-----pP--pP--pP------------------e---#---------------------pP----------y-##--------|---
-------------#####----ee---##---ee-----pP-----------ee---e--ee-e---pP-------e-ee-------------e--pP--------e-pP--e--pP--pP--pP----------------------#-----ee--------------pPe---------y-##--------#---
#####################################################################################----##########---##############################---##########--##################################################
