----------------------------------------------------------------------------------------------------------------------------------------------------------------------------------------------------------------
----------------------------------------------------------------------------------------------------------------------------------------------------------------------------------------------------------------
----------------------------------------------------------------------------------------------------------------------------------------------------------------------------------------------------------------
------------------------------------------------------------------------------------------------------------------------------------------------------------------------------------------------------------|---
------------------------------------------------------------------------------------------------------------------------------------------------------------------------------------------------------------|---
------------------------------------------------------------------------?-------------------------------------------------------------------------------------------------------------------------##--------|---
-------------------------------------------------------?-----------------------------------------------------------------B-----------------------------------------oooo--------------------------###--------|---
------------------------------------------------------------------------------------------------------------------------------------------------------------------------------------------------####--------|---
-----------------------------------------------------------------------------------------------------------------------------------------------------------------------------------------------#####--------|---
--------------------------------------------------???-------------------?--------------e----------------------------------------------------------------------------e-------------------------######--------|---
-------------------------------------------------------#------------------------------------------------------------------------------------------------------------pP-----------------------#######--------|---
-------------------------------------------------------#--------------#---#----------------------------------------------#------------------------------------------pP----------------------########--------|---
----------e-------e-ee-----e-e-------e-e----#----------#----e--ee-e---#-e-#-----------------------------e-------ee-e-----#-----e------ee-e-------e---------e-ee-----pP------e-ee-----ee----#########--------#---
###########################################################################--#########################################--###--###################################################################################