-----------------------------------------------------------------------------------------------------------------------------------------------------------------------------------------------------
-----------------------------------------------------------------------------------------------------------------------------------------------------------------------------------------------------
-----------------------------------------------------------------------------------------------------------------------------------------------------------------------------------------------------
-------------------------------------------------------------------------------------------------------------------------------------------------------------------------------------------------|---
------------------------------------------------------------------------------------------------------------------------------------------------e------------------------------------------------|---
---------------------------------------------------------------------------?-------?BB------------------BB?BBB?BBB--------BB?------------------B?B--B?B--------------------------------##--------|---
--------------------------------------------------------------------------------------------------------------------------------------------------------------------------------------###--------|---
--------------------------------------------------------------------------------------------------------------------------------------#---------------------------------#-----------e####--------|---
------------?--?---------------e------------------------------------------e-ee------------------e------------e------------BBB-------e##---------------------------e-----#-----------#####--------|---
---------?-e------eBBB---e-----pP-----------------e---B--------------##########--##-------------pP------BBBBBBBBBBB----------------e###--------B?B--B?B--------B?BBB----#----------######--------|---
-------------------------pP----pP-----------------pP--------e-------##--------#--##-------------pP---------------------------------####---------------------e--e-------##--------e#######--------|---
-------------------------pP----pP-----------------pP--------pP-----###--------#--###------------pP---------------------y----------#####----------------------------e---##--------########--------|---
-------------------------pP--e-pP-----------ee-e--pP-e------pP----####--------#--###--e-e---e---pP---------------------y---------######------e-----e-ee----------------##-------#########--------#---
######################################---#############################--------#--########################################----##########--#################################---########################