-------------------------------------------------------------------------------------------------------------------------------------------------------------------------------------------------------------------------
-------------------------------------------------------------------------------------------------------------------------------------------------------------------------------------------------------------------------
-------------------------------------------------------------------------------------------------------------------------------------------------------------------------------------------------------------------------
-------------------------------------------------------------------------------------------------------------------------------------------------------------------------------------------------------------------------
-------------------------------------------------------------------------------------------------------------------------------------------------------------------------------------------------------------------------
-----------------------------------------------------------BBBBBB?B-----------------------------------------------B?BBBBBB---------------------------------------------------------------------------------##--------|---
---------------------------------------------------------------------------------------------------------------------------------------------------------------------------------------------------------------------|---
---------------------------------------------------------------------------------------------------------------------------------------------------------------------------------------------------------#-----------|---
----------------------------------------------------e----------e-------------------------------------------------------e-----e---------------------------------------------------------------------------------------|---
----------------------------------------------------pP-----BBBBBBBB---#-------------------------------------##----BBBBBBBB---pP-----------------------------------------e--------------------?---------#-------------|---
---------------------------------c------------------pP----------------##----------------------#-------------##---------------pP-----------------------------------------pP-------------------------------------------|---
-----------------c---------e-----c------------------pP----------------###------------c----e---#-------------##---------------pP---------------------------------e-------pP------------------------#--#---------------|---
-----------------c---------------c------------------pP------------e---####-----------c--------#-------------##-------e-------pP--------e---------e----------------------pP-------e-------e--------#------------------#---
####################################################################--####--###############################################--##--###################################################################-----------##########