----------------------------------------------------------------------------------------------------------------------------------------------------------------------------------------
----------------------------------------------------------------------------------------------------------------------------------------------------------------------------------------
----------------------------------------------------------------------------------------------------------------------------------------------------------------------------------------
-------------------------e----------------------------------------------------------------------------------------------------------------------------------------------------------|---
------------------------------------------------------------------------------------------------------------------------------------------------------------------------------------|---
-----------------------------?B---------------------------------------------------------------------------?--------------------------------------------------------------###--------|---
----------------------------------------------------------------------------------#BBB-----------------------------------------------------------------------------------###--------|---
---------------------------------------------------------------------oo----------##----------------------------------------------------------#BB--o----------------------###--------|---
--------------------------------------------------------------------------------###?--------------ooo------------------#BB-??---------------##------------------------#--###--------|---
---------??-----------------####--BB?------------------ooo-------###------------###------------e----------?-----------##-------------------###--B?-------------------##--###--------|---
-------------------------#####----------------------------------####----------#-###--BBB-------pP--------------------###------------------####----------------------###--###--------|---
----------------------######-----------------------------------#####---------##-###------------pP-------------------####-----------------#####---BBB---------------####--###--------|---
-------------------#######------------------------------------######------------###------------pP------------------#####---BBBBB--------######--------------------#####--###--------#---
#############--#########------##--################--###############---################---###############################-------##-############------#########---#######--###############
