-----------------------------------------------------------------------------------------------------------------------------------------------------------------------------------------------------------------------
-----------------------------------------------------------------------------------------------------------------------------------------------------------------------------------------------------------------------
-----------------------------------------------------------------------------------------------------------------------------------------------------------------------------------------------------------------------
--------------------------------------------------------------------------------------------------------------------------------------------------------------------------------------------------------------------|--
-------------------------------------------------------------------------------------------------------------------e------------------------------------------------------------------------------------------------|--
------------------B?B------e----------------------------------BBBBB-----BBBB?-----------------------------e---e---BBBBBBBBB------------?B---BB-------------BBB----e--------------------------------------###--------|--
---------------------------pP----------------------------e------------------------e-----------------------pP------------------------------------------------------pP--------------------------------e---####--------|--
---------------------------pP----------------------e-----pP-----------------------pP----------------------pP------------------------------------------------------pP-----------------------------------#####--------|--
--------------e--------e---##------------e---------pP----pP-----------------------pP-------------e--------pP-------------------------BB---------------------------pP-----e--------e-----------------e-######--------|--
-----BBB------pP---?---pP----------------pP---B?---pP----##----------------e-?----pP-----e-------pP------B##B------------------------------BBB------e--##--BBB----##-----pP-----e-pP----e-----------pP######--------|--
--------------pP-------pP-----e-e--------pP--------pP---------e------e-----pP--e--pP-----pP------pP-e---------e---------------e---e---------------#-pP-##----------------pP---e-pPpP----pP----------pP######--------|--
--------------pP-------pP-----pPpP-------pP--------pP---------pP-----pP----pP--pP-pP-----pP------pP-pP--------pP--------------pP--pP-------------##-pP-###---------------pP---pPpPpP----pP---------#pP######--------|--
--------------pP----e--pP-----pPpP-------pP---e----pP---------pP-----pP----pP--pP-pP--e--pP------pP-pP--------pP--------------pP--pP------------###-pP-###e-------e------pP---pPpPpP----pP--------##pP######--------#--
######################################################################################################################------############-#-########-###################################################################
