-------------------------------------------------------------------------------------------------------------------------------------------------------------------------------------------------------------------------------------------------------------------------------------------------------------------------------------------------------------------------------------
-------------------------------------------------------------------------------------------------------------------------------------------------------------------------------------------------------------------------------------------------------------------------------------------------------------------------------------------------------------------------------------
-------------------------------------------------------------------------------------------------------------------------------------------------------------------------------------------------------------------------------------------------------------------------------------------------------------------------------------------------------------------------------------
---------------------------------------------------------------------------------------------------------------------------------------------------------------------------------------------------------------------------------------------------------------------------------------------------------------------------------------------------------------------------------|---
------------------------------------------------------------------------------------------------------oo-------------------------------------------------------------------------------------------------------------------------------------------------------------------------------------------------------------------------------------------------------------------------|---
---------------------------------------------------------------------------------------------------------------------------------------------------BBBB?BBB------------------------------------------------------------------------------------------------------------------------------------------------------------------------------------------------------------##--------|---
-----------------------------------------------------------------------------------------------------------------------------------------------------------------------------------------------------------------------------------------------------------------------------------------------------------------------------------------------------------------------##--------|---
-----------------------------------------------------------------------------------------------------------------------------------------------------------------------------------------------------------------------------------------------e---------------------------------#-----------------------------------------------------------------------------------#-##--------|---
----------------------------e----------------------------o-----------e---?--------o----e---o-----e-------------------------------------------------------------------------------BB?BBBBB-------------------------------oo-----------------e---pP-------------------------------##--oo------o----o-------------------oo---oo-----------------------------------------#-##--------|---
----------------------------pP---------------------------------------pP----e-----------pP--------pP----------------------------------e------------#----?----#--------------------------------------------------------------------------e---pP--pP------------------------------###---------------------------------------------------------------e-----------------#-#-##--------|---
----------------------------pP---------------------------------------pP----pP----------pP--------pP---------e------------------------pP-----------#-----e---#-------e------------------------------------------------------------------pP--pP--pP-----------------------------####---------------------------------------------------------------pP---------e------#-#-##--------|---
----------------------------pP---------------------------------------pP----pP----------pP--------pP---------pP-----------------------pP-----------#---------#-----------e----------------------------------#---------------------------pP--pP--pP----------------------------#####----------------------#---#------------------------------------pP---------pP---#-#-#-##--------|---
-------e-------e-e-------e--pP----e-e---------------e---------ee-e---pP--e-pP----------pP--------pP-e-ee----pP-e-----e----ee-e-------pP-----e-ee--#---------#------------------------------------------ee--#---------------------ee-e--pP--pP--pP---e----ee-e--e---------e--######e---------------------#-e-#-----------------------e------e-ee--pP---------pP---#-#-#-##--------#---
#######################################-#-##-##-##-###############################################################################################################-#-##-#-##-#################-#-#-###################------##########-##--##--############################################---##---################-----#----###################################-#-#-#-##############