------------------------------------------------------------------------------------------------------------------------------------------------------------------------------------------------------------------------------
------------------------------------------------------------------------------------------------------------------------------------------------------------------------------------------------------------------------------
------------------------------------------------------------------------------------------------------------------------------------------------------------------------------------------------------------------------------
--------------------------e-----------------------------------------------------------------------------------------------------------------------------------------------------------------------------------------------|---
--------------------------------------------------------------------------------------------------------------------------------------------------------------------------------------------------------------------------|---
------------------?--------------------------------------?-?-------------------------?-------------------------------------------------------oooo---------------------------------------------------------------##--------|---
--------------------------------------------------------------------------------------------------oooo----------oooo------------oooo---------------------------------------------------------------------------###--------|---
--------------------------------------------------------------------------------------------------------------------------------------------------------------------------------------------------------------####--------|---
-----------------------------------oo------------------------------------------------------------------------e---------------e-------------------------------------------------------------------------------#####--------|---
--------------e---?---------------?--?-------------------?-?-----------------------oooo----------------------pP--------------pP------------???BB???---------------------------------------------------------######---o----|---
--------------pP--------------------------------------------------------------------------------#------------pP--------------pP-----------------------------e-------------------------#--------------------#######--------|---
--------------pP--------------------------------------------------------------------------------#------------pP--------------pP-----------------------------pP------------------------#-------------------########--------|---
--------------pP--------------------------------------------------------------------------------#------------pP--------------pP-----------------------------pP------------------------#------------------#########--------#---
#########################--############################################----###################################################################--#######################---###--########--#####################################
