----------------------------------------------------------------------------------------------------------------------------------------------------------------------------------------------------------
----------------------------------------------------------------------------------------------------------------------------------------------------------------------------------------------------------
----------------------------------------------------------------------------------------------------------------------------------------------------------------------------------------------------------
------------------------------------------------------------------------------------------------------------------------------------------------------------------------------------------------------|---
----------------------------------------------------------------------------------e-------------------------------------------------------------------------------------------------------------------|---
----------------------?---------------------------------------------------------BBBBBBBB---BBB?--------------?-----------BBB----B??B--------------------------------------------------------##--------|---
-------------------------------------------------------------------------------------------------------------------------------------------------------------------------------------------###--------|---
-------------------------------------------------------------------------------e----------------------------------------------------------------------------------------------------------####--------|---
----------------------------------------------------------------?------------------------------------------------------------------------------------------------------------------------#####--------|---
----------------?---BMB?B---------------------pP---------pP------------------BMB--------------?-----B?----?--?--?-----B----------BB------#--#----------##--#------------BB?B------------######--------|---
--------------------------------------pP------pP---------pP-----------------------------------------------------------------------------##--##--------###--##--------------------------#######--------|---
----------------------------pP--------pP------pP---------pP----------------------------------------------------------------------------###--###------####--###-----pP--------------pP-########--------|---
---------------------e------pP--------pP-e----pP-----ee--pP------------------------------------ee---------e-----------------ee-ee-----####--####----#####--####----pP---------ee---pP#########--------#---
#####################################################################--###############---################################################################--###############################################