----------------------------------------------------------------------------------------------------------------------------------------------------------------------------
----------------------------------------------------------------------------------------------------------------------------------------------------------------------------
-BB----BBBBBBBBBBBBBBBBBBBBBBBBBBBBBBBBBBBBBBBBBBBBBBBBBBBBBBBBBBBBBBBBBBBBBBBBBBBBBBBBBBBBBBBB?BBBBBBBBBBBBBBBBBBBBBBBBBB-----BBBBBBBBB--------------BBBBBBBBBBBBBBBBBBBBBB
-BB------pP----pP------------------------------------------------BBBBBBBBBBBBBBBBBBBBBBBBBB------BBBBBBBBBBBBBBBBBB-----pP--------------------#-------------------------pP--
-BB------pP----pP-------e----------------------------------------BBBBBBBBBBBBBBBBBBBBBBBBBB------BBBBBBBBBBBBBBBBBB-----pP----------------------------------------------pP--
-BB------pP----pP---??????---------------------------------------BBBBBBBBBBBBBBBBBBBBBBBBBB------BBBBBBBBBBBBBBBBBB-----pP----------------------------------------------pP--
-BB------e-----pP------------------BBBBBBB------------------------------------------------------------------------------pP-------BBBBBBBB-#--------#--------------------pP--
-BB------------pP------------------BBBBBBB--BBBBB-----------------------------------------------------------------------pP-------BBBBBBB--------------------------------e---
-BB------------pP------------------BBBBBBB--BBBBB---o-----ooooooo--------------------------e--e-------------------------pP-------BBBBBB-------------------------------------
-BBB-----------pP---BBBBBBBBBBBBB--BBBBBBB--BBBBB?BB?BBBBB???????BBBBBBBBBBBB?----BBBBBBBBB--pP--------------e-e--------pP------?BBBBB---------------------------e----------
-BB------------e----BBBBBBBBBBBBB-------------------BBBBBBBBBBBBB----------------------------pP----------###-pPpP-------e----------------------------------------pP----B-B-B
-BB-----------------BBBBBBBBBBBBB---------e---------BBBBBBBBBBBBB--------------e-------------pP-------ee####-pPpP-----------------------------#-------oooooooo---pP----B-B-B
-BB-----------------BBBBBBBBBBBBB---------pP-----------------------------------pP------------pP------e-#####-pPpP-------------------------------------oooooooo---pP----B-B-B
-########--######e--##################################-##-#######################################-###e######-######e#######----#########--------------########---pP----B-B-B
-########--#######--##################################-##-#######################################-##########-##############----#########--#--------#--########---pP----B-B-B
