-----------------------------------------------------------------------------------------------------------------------------------------------------------------------------------------------------------------
-----------------------------------------------------------------------------------------------------------------------------------------------------------------------------------------------------------------
---------------BB-------------------####-------------------------------------------------------------------------------------------------------------------------------------------------------------------------
---------------pP--------------------pP--------------------------------------------------------------------------------------------------------------------------------------------------------------------------
---------------pP--------------------pP--------------------------------------------------------------------------------------------------------------------------------------------------------------------------
---------------e---------------------pP--------------------------------------e---##--------------BBBB-----------------------------------------------BBBBB-----BBBBB---------#----e---------------------#---------
-------------------------------------pP-----------------------------------e--e---pP---------------pP-----------------------------------------------B-----------pP---------------e--------------------------------
----------------e--------------------pP------------------------------------------pP---------------pP------------------------e---------------------BB-----------pP---------------pP-----------------e-------------
---------------e---------------------pP--------------------------------e---------pP---------------pP---------------------------------------------BBB-------?---pP---------e-----pP----------------e--------------
--------------e----QQQQQQ?QQQQQQQ?Q--e--------#----------------------------------pP---------------pP-----------------------B---B----------------BBBB-----------e---------e------pP------------?---pP-------------
--------------pP------------------------------#----------------------------------e------B---------e------------e---------------------------------------------------------pP-----pP----------------pP-------------
--------------pP--------------------------e---#-----------------------------------------b---------------------e--#-#---------------------e----------------------e--------pP-----pP----------------pP-------------
--------------pP-----------------------------e#-------------------#---------------e-----B----------e----------pP-#-#--------------------e-------B------------B-----------pP-----pP------e---------pP------------#
#########################ee#####e#e############-----##e############-------------########################e###########-------------######e-#####################-#######e####-----#######e-######---#######-------#
###############################################-----###############-------#-----####################################-------------######pP#####################-############-----#######pP######---#######-------#
