--------------------------------------------------------------------------------------o---------###################################################################---------------------------------------------------------------------------------------------------
---------------------------------------------oo---------------------------------------o---------###################################################################------------------------------------------------------------------------------------oo-------------
--------------------------------------------------------------------------------------o-------------------------------------------------------------------------------------------------------------------------------------------------------------------------------
-------#------------------------------------------------------------------------------o--------------------------------------------------e-------------------------------------------------------------------------------------------------------------------e--------
--------------------------------------------------###---------------------------------o---------------BBBBBBBBBBBBBBBB----BBBBBBBBBBBBBBBB--BBBBBBBBBBBBBBBB------------------------e--------------------------------------------?--e-----------------#---###---------
------------------------------------e--------e----###---------------BBB-BBB-----------o-------------------------------------------------------------------------------------------------e-----------------------------------------------e-------------------###-------
------------------------------------?------?-e-------------?--------------------------o------------#--------------------#-------------------#-----------------------------------------------------------------------------------------------###--#---?-e-------------?
---------------------------------------------pP---------------------------------------o----------e-------e------------e-----------------e-e------------------------------------------------------------------BBB----------------------------###--------pP-------------
----------------------------------------###--pP------###--------------------------------------##################BB######BB##########BB######BB##########BB######BB----------------------------------------------------BBB---------???-------###-e-###--pP------###----
----------------------------------------##-e-pP------###--------------------------------------##################--######--##########--######--##########--######--------------------------------------------------------------------------#####-pP###-epP------###----
-----------------e----------------------#########-----#######--------------------------------###-#-######-----###-###-----###-----###-###-----###-----###e###-#-#-------------------------------------------------------------------------#####-pP#########-----######
----------------############-#-################-----#######----------------------------------###-#-######-----###B###-----###-----###B###-----###-----###B###-#-#-------------------###-----------------###-------------------##-e----###-#####-pP#########-----######
----------------###########------#######---------------------------------------------------####----------ooooooo--##---------ooooooo--##---------ooooooo--##----------------------e-###-----------------###-------------------###########-#####-###-------------------
----------------###-----------------------------------------------------------------e--e---------#####---#######-----#--e----#######------e-#----#######----e-----##-----e--------######-------e------#####-------------------###---------#####-###-------------------
--#################------------------------#######----------------------------------pP##--######---#--###-------#############-------#############-------##########----################----#################-------------------###---------##---------#######----------
