---------------------------------------------------------------------------------------------------------------------------------------------------------------------------------------------------------------------------
---------------------------------------------------------------------------------------------------------------------------------------------------------------------------------------------------------------------------
----------------------------------------------------B----------------------------------------------------------------------------------------------------------------------------------------------------------------------
--B------------------------------------------------------------------------------------------------------------------------------------------------------------------------------------------------------------------------
---------------------------BBB----BBBB---------------------e--------------------------------------------------------------------------------------------------------------------------e------------------------------------
BB-BB---------#??-??#--------------------------BBBBBB----???????----------------e-----------------------------------------------BBBBBBB---------------e------e------------------------B--------------------##--------------
BB-BB---------#-----#----------------------------------------------------------BBBB----------------------------------------------------------------e----------------------------------------------------e------------------
--------------#-----#------#----------------------------------------------------------------------------------------------------------------------------------------------------------?-----------------#------------------
B-B-BBB-------#e-e--#------#ee-------#----------------------e--------------#-e--e------------------------------------------------e--e-----------#BBBBBBBBBBBB-----------------e----------------------e--#------------------
B-B-BBB-------#??-??#------#BBBBBBBBB#------------------????????-----------#B?BBBBB---#-----------------------------------------BBBBBBB--------##-----------------------??----#-------e--------------#--#--------------B---
BBBBBBB----------------------------------------------------------------------------ee-#--------------------------------?????------------------###----oooooo-------------------#-------#-----------e--#--#------------------
-B-B-BB-------------e---------------------------------------------------#--BBBBBBBBBBB#------------------------------------------------------####-----------------------------#-------#-----------#--#--#------------BB-BB-
-B-B-BB-----------------------------------------------------------------#-------------------------------e-e---------------------------------#####----oooooo-------------------#-------#-----------#--#--#--------#---BB-BB-
######################################----###------#################################################################################--#######################-----#--#####--############-#######--#--#--#-----#############
