-------------------------------------------------------------------------------------------------------------------------------------------------------------------------------------------------
-------------------------------------------------------------------------------------------------------------------------------------------------------------------------------------------------
----------------------------------------------------------------------------------------e--------------------------------------------------------------------------------------------------------
-------------------------------------------------------------------------------------------------------------------------------------------------------------------------------------------------
-------------------------------------------------------------------------------------------------------------------------e-----------------------------------------------------------------------
--------------------------------------------------------------------------------BBBBBBBBB?B--------B----B--------------------e------------BBBBBB----------################--------------#--------
---------BBBBBBBBBBBBBBBB--------------------------Be---------------e------------pP-------------------------------B--------e---------------------------------pP-------pP-------------------------
-----------------------------------B--------B------------???------e--------------pP----------------------------------------pP--------------------------------pP-------pP-------------#-----------
-----------------------------------b------------------------------pP-------------pP----------------e-----------------------pP--------B-----------------------pP-------pP---------e---------------
--------------BBBBBB------e-------###--B-----------------------??????????--------pP---------------e------------------#-----##-------####eBBBBBB--------------pP-------pP--------<----------------
---------------------------------####--------------------------------------------e----------------pP---------e---------------------######--------------------e--------e---------pP---------------
--------------------------------#####---------B---------------------------------------------------pP--------e---------------------#######---------------------------------------pP---------------
-------------------------------######---------b-------------B---------------------e---------------pP--------pP-----#-------------########----------B----------e--------e--------pP--------------#
####################------B---###############################--#####ee##############################################-------------###############e##############-########-#####--#################
####################----------###############################--#####################################################-------------##############################-########-#####--#################
