--------------------------------------------------------------------------------------------------------------------------------------------------------------------------------------------------------------------------------------------------------------------------------------------------------------------------------------------------------------------------------------------------------------------------------------------------------
--------------------------------------------------------------------------------?------------o--------------------------------------------------------------------------------------?------------o------?------------o----------------------------------------------------------------------------------------------------------------------------------------------------------------------------------------------------------------------------------
----------------------------------------------------------------------------------------------------e--------------------------------------------------------------------------------------------------------------------------------------------------------------------------------------------------------------------------------------------------------------------------------------------------------------???----------------------------------
---------------------------------------------------------------------------------------------o----###--------------------------------------------------------------------------------------------o----##----#--------o----###---------------------------------------------------------------------------------------------------------##----------------------------------------------------------------------------------------------------------------
-------------------------------------------e----------------------------------------------------###-------------------------------------------------------------------------------------------------###-----------------###-------------------BBB----------------------------e----------------------------------------------------ooo-##------------------##---------------------------------------##---------------------------------ooo---------------
----------------------------------------BBBB------------------------------------##---------e-o--#-----------------------------------------------------------------------------------##---------e-o--#---##------e----o--#--------------------------e----------------oooooo--------------oooooo---#--------------------------------ooo----------------------------------------##--------------------##--------------ooo----------------ooo##-------------
-----------------------?---------------------------------------?-----------------##---------------------------------------------------##-#-----?-------------------------------------##------------------##---------e------------------------------?----------------######--------------######---#--------------------------------ooo----------------------------------------##-----------------------------------####----------------ooo##-------------
--------------------------------???--------------------------------------??------------------##----------------------------------------##o#--------------??------------------------------------#-##------------------##-------------------------------------??--------------<>------------------<>----------------------------------------------------------------------------------------------##------------------------------------------------------
--------------------------------------------------------------------------------------------##-----------------------BBB-------o-##-o-##o#--------------------------------------------------e---##------------------##--------------BB--------------------------------------[]------------------[]--------------------------------###---------------------------------------------------------####--------------------------###-------###---------------
----------------------------------------####--------------------------------------####--######-----------BBB---------------------##---##o#--------------------------------------------####--######--------####--######-----------------------------#------------------------[]------------------[]--------------------------------###---------------------------------------------------------------------------------------###-------###---------------
------------------------------e------------------------------------------#-----------------------------------------------#--##-o-##-o-##o#---------------#-----------------------------------------------------------------------------------------#---------#-------------###--------##-------???--------####--------------------------------------##------------------##--------------------------------------------------###-------------------------
----------------------<>--------------------------------------<>---------#--------------------------------------------------##---##---##o#----<>---------#----------------------------------------------------------------------------------------<>---------#------------------------##---e--------------####--------------------------------------##------------------##------------------------------------------------#####-------------------------
----------------------[]--------<>----------------------------[]--------<>----------------------------------------------<>--##-o-##-o-##o--#--[]--------<>-------------#--------------------------------------------------------------------------[]--------<>------------------------##------------------####--------------------------------------##------------------##------------------------------------------------#####-------------------------
----------------------[]--------[]--e-------####------##e-----[]--------[]------------##--------------------------------[]--##---##---##o--#--[]--------[]------e----e-----e--------------##------------------##----------------------------------[]--------[]-------------e---e------##------------------####--------------------##--##--##--##--####------------------##------------------------------------------------#####-------##--##--##--##--##
##########################---################----------###########---###################--------------------------------##--##-o-##-o-##o--#######---#######################################------------########------------------BBB-----------######---#####################################################eeeeeeeeeeeeeeeeeeee######ee##ee##ee####eeeeeeeeeeeeeeeeee##eeeeeeeeeeeeeeeeeeeeeeeeee##eeeeeeeeee-----####-#####eeeeeee######ee##ee######
##########################---################----------###########---###################--------------------------------##--##---##---##-#########---#######################################------------########--------------------------------######---#######################################################################################################################################################-----###################################
