############################################-oooooooooooooo-####-oooooooooooooo-------------------##############################################################-----------------------##################################BBBBBBBBBBBBBBBBBBBBBBBBBBBBBBBBBBBBBBBBBBBBBBBBBBBBBBBBBBBBBBBBBBBBBBBBBBBBBBBBBBB
#################################################################################----------------################################################################-------e---------------##################################BBBBBBBBBBBBBBBBBBBBBBBBBBBBBBBBBBBBBBBBBBBBBBBBBBBBBBBBBBBBBBBBBBBBBBBBBBBBBBBBBB
########--------#################################################################-------------------############################--------############--------############pP-------------####------------####-----------------------BBBBBBBB#--------------------BBB#----------------BBB#---BBBBBBBBBBBBBBBBBB
#####------------####------------------##########################################-------e----------##------------------######------------########------------##############-------------##----------------------------------------BBBBBBBB#--------------------BBB#----------------BBB#---BBBBBBBBBBBBBBBBBB
##-----e----------##--------------------#########################################---------------------------------------##-----e----------####-----e----------##-----------------------##--e-----------e---------------e-------e--BBBBBBBB#e-------e----------e--------e----------e-----------------------BB
##----------------##-----------------------------------------------------------------e------e---------------------------##----------------####----------------##----e------------e------##------------------------------------------------------------------------------------------------------------e-e-BB
##---e--------e---##----------------------e------------e------e------------e--------------------------------------------##---e--------e---####---e--------e---##-----------------------##---------------------#------------------------e--------------------------------------------------------------------
##----------------##----------------------------------------------------------------------------------------------------##----------------####----------------##-----------------------??-------BBBBB#-------#-#------------------BBBBBBBB------------------------------------------------------------------
##----------------##-------------------------------------------------------------#--------------------------------------##----------------####----------------##-----------------------BB-------B-----------#---#-----------------BBBBBBBB------------------------------------e-----------------------------
##-#--------------------------e-------------------------------------------------------------------------------e---------##------------------##---------#---------------------#---------BB-------B----------#-----#------------BB#---------------------------------------------------------------------------
##-----?????--------------e---pP---e----------------------#---------------------e-------------------------e---pP---e----##-----?????--------##-----?????--------------------###--------BB-o-oeo-B---------#oooEoooB------BBB#-BB#------------------------e------------------------------------------e----BBB
---------------------e----pP--pP---pP-------------------------------------------pP-------------------e----pP--pP---pP------------------------------------e-----------------#####---------########--------#oooo?ooooB-----BBB#-BBBBBBBBBBBBBB----BB------------------BB--------------e--------------------BBB
-------------##------pP---pP--pP---pP---############e-####e-############e-####e-pP-------------------pP---pP--pP---pP----------------##----------------e-##---------------#######----------o-o-o--------#ooooooooooo#----BBB#-BBBBBBBBBBBBBB#---BB---------e---BBBBBBB-------------BBBBBBB###############BBB
-------------##------pP---pP--pP---pP---############pP####pP############pP####pPpP-------------------pP---pP--pP---pP----------------##------------------##--------------#########----###################oooooooooooo#BBBBBB#-BBBBBBBBBBBBBB#---BB-------######BBBBBBB-------######BBBBBBB---------------BBB
##########################pP--pP--######################################################----##############pP--pP--###################################$$$########----################-----------------------B#---------BBBBBB#-BBBBBBBBBBBBBB#---BB--BBBB-------BBBBBBB--BBBB-------BBBBBBB---------------BBB
##########################pP--pP---####################################################----###############pP--pP---##############################################----##############BBBBBBBBBBBBBBBBBBBBBBBBBBBBBBBBBB-BBBBBB#-BBBBBBBBBBBBBB#---BB--BBBB-------BBBBBBB--BBBB-------BBBBBBB---------------BBB
