------------------------------------------------------------------------------------------------------------------------------------------------------------------------------------------------------------
------------------------------------------------------------------------------------------------------------------------------------------------------------------------------------------------------------
------------------------------------------------------------------------------------------------------------------------------------------------------------------------------------------------------------
---------------------------------------------?--------------------------------------------------------------------------------------------------------------------------------------------------------------
------------------------------------------------------------ooooo---------------------------------e----------------------------------------------------------------------e----------------------------------
-----------------------------e--------------------------##--#####--------------------------------e------------------###--------####--------###--------------#######--------#######--------####e#------------
------------------------e-----------##-------##-----##---------------------e---------------------pP--------##-----------------------------------------##----------------------------------------------------
---------------------------##--------------------------------------------------------------------pP------------------------oo-------------------------------------------------------------------------------
---------------------------------------------------------------------------------------------e---pP------------------------BB-------------------------------------------------------------------------------
--B-------------#####-------o------------------------------------------##--------------###--e----pP----------------------------------------------##---------------------------------------------------------
----------------------------o--##-----------------------------------------------e-----------pP---pP---------------------------------------------------------------------------------------------------------
BB-BB---------------------------------------------------------------------------------------pP---pP---------------------------------------------------------------------------------------------------------
BB-BB---------------------------------------------------------------------------------------pP---pP----------------o---o--------------------------------------------------------------------------------#---
############------------------------------------------------########------------#######-----pP---##-###------------#---#--------------###-------------------------------------------------------------#-####
--------------------------------------------------------------------------------------------pP---##-------------------------##------------------------------------------------------------------------#-####
