---------------------------------------------------------------------------------------------------------------------------------------------------------------------------------------------------------------------------------------------------------------------------------------------------------
-----------------------------------------------------------------------------------------------------------------------------------------------------------------------------------------------------------------------------------------------------e---------------------------------------------------
----------------------?S?--------o-o-o---------------------------------------------------e--------------e-----------e-----e-----e------------------e---------------???-------eo-o-o-------e---e---e---------------e----e---------------------------???--------o-o-o------------------------------?-------
----------------------------e-----#####--------------e---e-------------------------------?---oo---------------e-------oo------------------oo---e-------------e---------------#######--------------------------e-----------------------?---oo-----------------#######-------------------oo--------B--BB-BB
--------------------------------e------#--------------###--------------BBB------------------####--------------------------------------e--------------------------------------#------#--------------###-----------------###---------------####----------------#------#--------e-----------------------oooB
---------------------------------------#--------------#--#----------------------------------#---#------ooo------ooo--------ooo------ooo--------------------------e----------e#------#--------------#--#----------------#--#--------------#---#---------------#------#---ooo----e-ooo-----------------oooB
-------#------------######-----##------#--------------#--#----------------------------------#---#---------------------------------e------------------------------######-----##------#--------------#--#---------e------#--#--------------#---#---######-----##------#--------------------------------oooB
--------------------#-----#----#-#e----#----------###-#--#--------BBB--------------------##-#---#---BBBBBBBBBBBBBBBBB--BBBBBBBBBBBBBBBBBBB---##----------------e-#-----#----#-#-----#----------###-#--#------------###-#--#-----------##-#---#---#-----#----#-#-----#BBBBBBBBBBBBBBBBBB-e------------BBBB
---------------######-----#----#-#?----#----------#--##--#-------------------------------#-##-o-o-o------------------------------------------#-#---------------###-----#----#-#-----#----------#--##--#------------#--##--#-----------#-##-o-o-o-#-----#----#-#-----#------------------------------------
---------------#----#-----#----#-#-----#----------#--##-####-----------------------------#-##-######-----------------------------------------#-#-----###########-#-----#---e#-#-----#----------#--##-####----------#--##-####---#-----#-##-#######-----#----#-#-----#------------------------------------
---------------#----#-----#--###-#-----#------###-#--##-#---#----------------------------#-##-#-----#----------------------------------------#-#-----#-#-------#-#-----#--###-#-----#------###-#--##-#---#-----###-#--##-#---#--------#-##-#-----#-----#--###-#-----#------------------------------------
---------------#----#-----#--#---#-----#------#--##--##-#---#---------------------e----########-----#----------------------------------------#-####--#-#-------#-#-----#--#---#-----#------#--##--##-#---#-----#--##--##-#---#-e----########-----#-----#--#---#-----#-------------------------------#----
------------#####---#-----#--#---####--#-###--#--##--##-#---#---------------------pP---#-------#----#----------------------------------------#-#-#-#-#-#-------#-#-----#--#---####--#-###--#--##--##-#---####--#--##--##-#---#-pP---#-------#----#-----#--#---####--#----------------------------BBB-----
------------#----#--#-----#--#---##--#-#-#--#-#--##--##-#---#---------------------pP---#-------#----#----------------------------------------#-#-#-#-#-#-------#-#-----#--#---##--#-#-#--#-#--##--##-#---##--#-#--##--##-#---#-pP---#-------#----#-----#--#---##--#-#------------------------------------
--############---#--#--########--##--#-#-#--#-#--##--##-#---#-------------------###########----#----#----------------------------------------#-#-#-#-#-#-------#-#--########--##--#-#-#--#-#--##--##-#---##--#-#--##--##-#---###########----#----#--########--##--#-#----------------------BBBB----------
