--------------------------------------------------------------------------------------------------------------------------------------------------------------------------------------
--------------------------------------------------------------------------------------------------------------------------------------------------------------------------------------
---------------------------------------------------e-------------------------------------------?--------------------------------------------------------------------------------------
--------------------e-----------------------------e--------------------------ooo------------------------------------------------------------------------------------------------------
--------------------------------------------------pP-------------------------ooo------------------------------------------------------------------------------------------------------
--------------#####e#####-----------------------##pP#------------###--------####--------------####--o---------------------------------------------------BB----#---##-----###----------
----------------------------------------------------------------------------------------------------o---------------------------------------------------------------------------------
------------------------------------------------------###---------------------------###---------------###-------------------------------------------------------ooooooo---------------
-------------------------------------------------------------------------------------------------------------------------------------------------------oooo-----ooooooo-----------e---
-----------#####e#ee#######---------------#e###-----------------------------------------------------------------###e##-----####---------------###------####-----------e---------------
----------------------------------------------------------------------e-----e--------------------------------------------e-----------###-----e-----------------------e----------------
--------###----------------------------------------------------------e-----e----------------------###---------------------------------------e-------------------e----pP---------------
-----------------------------------------------------------###-------pP----pP---------------------------------------------------------------pP-----------------e-----pP--------------#
###########---------------##########ee#e##--------------------------#pP#--#pP#####-------##e#--------------#####----------------------------pP-----------------pP----pP-------------##
--------------------------------------------------------------------------------------------------------------------------------------------pP-----------------pP----pP-------------##
