---------------------------------------------------------------------------------------------------------------------------------------------------------------------------------------------
---------------------------------------------------------------------------------------------------------------------------------------------------------------------------------------------
---------------------------------------------------------------------------------------------------------------------------------------------------------------------------------------------
---------------------------------------------------------------------------------------------------------------------------------------------------------------------------------------------
----------------------------------------------------------------------------------------------------------------------------------oo---------------------------------o-o---------ooo---------
--------------------------------------------------------------oooo----------------------------------------------------------------oo-----------------------------##--o-o---------###---------
--------------------------------------------------------------oooo---------------------------------------------------------------------------------------------------------------------------
--------------------------------------------------------------------e-----------------------------------------------e------------------------------------------------------------------------
-------------------------------------------------------------------------------------------------------ooo--------------ooooo----------------------------------------------------------------
----------------------------oooooooooo----------------###------------------------------------##-------#####--------#---#######-------?--------------####---##---------##---------------------
---------###--###-----------oooooooooo-----------------------##--##--------------------------#-------------------------------------------------------------###-------------------------------
--------####e--------------------------------------------------------------------------------------------------------------------------------------------------------------------------------
-------#####-------------###########e#####---------------------------##---------------------------------------------------------------------------------------------------------------------#
###########--------------##-------------##-########------------------------#########----##-----------------------------------###------------######-------------------------###########------#
###########--------------##-------------##----------------------------------------------#--------------------------------------------##-----------------------------------------------------#
