----------------------------------------------------------------------------------------------------------------------------------------------------------------------------------------##############--####################################################$$$$$$$$$$$$$$$$############--#######---########
-------------------------------------------------------------------------------------------------------BBBBBBBBBB-----------------------------------------------------------------------#-----#------#------------------------------------------------------------------------------------#####----------###
----------------------------------------------------------------------------------------------------------------------------------------------------BB-------------------------------o--#-----#------#---------------------------------------------------------------------------------------------------###
-------------------------------------------------------BB------------------------e-----------------------------------------------------------------------------------------------------#-----#--##--#----------------------------------------------------------------------------------------------------###
---#-----------------------------------------------------------#-----------------pP----------------------ooooooo-----------------------------------------------------------------#---o--#-----#---#--#-----#-------------------#-------------------------------------------------------------------------###
---------------------------------------------------------------------------------pP--------e-------------e------------------------------------------------------------------------------#-----#---#--#-------------------------------------------------------------------------------------------------#-###
---------------------------------------BBB---------------------------------------##--------?-----------##########----------------------------B---------------------------------------o--#-###-#---#--#---------#----#--------------#----#-----------------------------------------------------#-------------
----------------------------------------------------------------------------------------------------------------------------------------------------------------------####--####--------#---#-###-#--#---------#----#-----e--------#----#-----------------------------------------------------#------e##----
---------oo--------o---#-------------------#-------------------------oo--------o-------------------------------------------#-----------BBB-----#-------------------------------------o--#---#-----#--------#---#----#----------#---#----#----------#------#------------#------#---------------#--------#----
-----#------------------o-o-o-o-------------o-o-o-o--------------#------e------------------------------------------#--------o-o-o-o-------------o-o-o-o-------------#-------------------#---#-----#------------#----#--------------#----#----------e------#----##------#------#----##-------e-#--------#----
--------------------------BBB----BBB-----------BBB------------------------------------####-#-#-##---------????-----#----------------------------------------------------#-----------##--##--#-----#------------#----#-######-------#----#-######---???----#---##-------???----#---##--------e-#--------#-###
------------------------------------------------------------------------------e-------####-#-#-##--------------#---#--------------BBB-----------------------------------------------##--#---#----##------------#----#-######-------#----#-######---#------#--##--------#---------##-----------#----------###
---------e----##--##-------------------------------------------------e----##--BB####--####-#-#-##--------------#-----------BBB------------------------------------e--------------#--##------#----##------------#----#-######------------#-######---#------#-##---------#------e-##------------#----------###
---------pP---##--##-----------------#-------------------#-----------pP---##--######--####-#-#-##---##---------#----##-------------------#-------------------#----pP-------------#####------#----##-------------------######------e-------######-----------##-------#----------##---------###-------########
-######--pP---##--##-----------------------------------------######--pP---##--######-#####-#-#-##---##--------------##-----------------------------------BBB----######-----------#-----BB--------###########################################################--------############----------#######---########
--####---##---##--##------------------------------------------####---##---##--######-####--#-#-##---##################------------------------------------------######-----------#-------------BB-------####################################################--------############----------#######---########