------------------------------------------------------------------------------------------------------------------------------------------------------------------------------------------------------------------------------------------------------------------------------------------------------------------------------------------------------------------------------
----------------------------------------------------------------------------------------------------BBBBBBBBBBBBBBBBBBBBBBBBBBBBBBBBBBBBBB----------------------##############################################################################################################################################################################################################
-----------------------------------------------------------------------------------------------------B-------------------B--------------------------------------##############################################################################################################################################################################################################
-----------------------------------------------------------------------------------------------------B----e--------------B--------------------------------------##############################################################################################################################################################################################################
-----------------------------------------------------------------------------------------------------B---B?B?B?B?B?B?B?B-B---B?B?B?B?B?B?B----------------------##########################################------####----##########################------####----##############################################################################################################
-----------------------------------------------------------------------------------------------------B-------------------B-----------------------------------------------##------------------##---------------------------------------------##--------------------------------------##------------------##-----------##-------------------------##--##########################
--------------------------------------------------e--------------------------------------------------B-------------------B---------------------------e----------------e-------------------------------------------------------------------------------------------------------------------------------e---------------------------------------------##########################
-----------------------------??------------------??--------------------------------------------------BBBBo-e-o-o-o-o-BB--BBBBo-o-o-o-o-o-BB----------??---------------------------------------------------------------------------------------------------------------------------------#---------oo--------------------------------------oo--------##########################
---------------------BBBBB-------BBBB----BBBBB-------BBBB-----------------------------------------------BBBBBBBBBBBBBBB---BBBBBBBBBBBBBBB--BBBBB-------BBBB-----------------------------------------------------------------------------------------------e-------------------------------------------------------e---------------------------e-e-############################
---------------------------------------------------------------------------------------------------------pP----pP----pP------pP----pP----pP-----------------------------e-------------------e-------------------------e------------------------------e---------------------------------------------------##---------e----------------------------##-##########################
----------------------------e-------------------e---------------------------------------------e-----BB---pP----pP----pP-BB---pP----pP----pP-----------------------------pP-----e-------e----pP---------------?----------------------------BBB-----e--?-------------------------BBB----------------e------##---------pP--------------------e------##-##########################
----------------------------BBBB----------------BBBB------------------------------------------------BB---e-----e-----e--BB---e-----e---B-e----------BBBB---------e------pP------------------pP---e-------------------##--------------------------------------##-----------------------------------##------#---------pP---e----------------##-----##---------------------------
---------------------------------------------------------------B------------------------------------BB------------------BB-------------b------------------------------e-pP----------------e-pP------------------e---------------BBB---------------------------------------BBB-----------##--------##---####-e-----e-pP-----e----##--------##---####---------------------------
--e------------------------------------------e-----e----------e-------------------e-----------------BB------e----e------BB------e----e-e-#-------------------------##-pPpP-----##----e-##-pPpP-----##---------e-------------####-------------------e----------e-----####----------------##----e---##---####----##-pPpP-----##---##----e---##---####---------------------------
--pPBBBB------------BBBBBBBBBBBBBBBBBB--BBBBBBBBBBBBBBBBBB----pPBBBB--------------pPBBBB------------BB-----#pP---#pPBBBBBB-----#pP----pPBBBBBBBBBBBBBBBBBBBBBB--########################################--##################----------------------##################--------------------##--########---####-######################--########---####-######-#-#-#-#-#-#########
--BBBBBB------------BBBBBBBBBBBBBBBBBB--BBBBBBBBBBBBBBBBBB----BBBBBB--------------BBBBBB------------BBBBBBBBBBBBBBBBBBBBBBBBBBBBBBBBBBBBBBBBBBBBBBBBBBBBBBBBBB--########################################---#################-----------------------#################--------------------##--########---####-######################--########---####-######------------########
