-----------------------------------------------------------------------------------------------------------------------------------------------------------------------------------------------
-----------------------------------------------------------------------------------------------------------------------------------------------------------------------------------------------
-----------------------------------------------------------------------------------------------------------------------------------------------------------------------------------------------
-----------------------------------------------------------------------------------------------------------------------------------------------------------------------------------------------
---------------------------------------------------------------------------------------------------------------------------------------------------------------e-e-----------------------------
-------------------------------------------------------------------------------BBBBBBBBBBBBB-------------------BBB?BBB-------???-------------???????---------BBBBBBB-BB----------------#-------
--------------------------------------------------------------------------------------------------------------------------------------------------------------------e---------------e--#-------
------------------------------e----------------------------------------------------------------e-----------------------------------------------e------------------------------------##-#-------
------------------------------e-------------------e------?--?--?--------------------BBBBB------pP----------------------------BBB-------------BBBBBBB--------------------------------##-#-------
---------------???????------?-pP-------BBBBBB?----pP-----------------B------------BB----------?????------------BBBBBBB----------------e---------------e--------------e--------e-----##-#-------
-------------------------e----pP------------------pP---------------e------------e-----------------------------------------------------pP-------#------#-------e------pP-------pP----##-#-------
---------------------e---pP---pP-------------B----pP-----------e----------------pP----------------------------------e-----------------pP-------#------#--------------pP-------pP----##-#-------
-------------ee------#---pP---pP------------------pP---------------------#------pP----e---ee------------e-----------------------------pP----e--#------#--------------pP-------pP----##-#-------
######################---#######-#####--#######---####################---#######################-#-#################-#-#--#-------#####################################-------##-#####-########
