------------------------------------------------------------------------------------------------------------------------------------------------------------------------------------
------------------------------------------------------------------------------------------------------------------------------------------------------------------------------------
------------------------------------------------------------------------------------------------------------------------------------------------------------------------------------
-----------------------------------------------------e------------------------------------------------------------------------------------------------------------------------------
----------------------------------------------------------------------------------oo---------------------------------o-o---------ooooo-----###----ooo-------------------------------
--------------------------------------###-----------------------------------------------------------------------###-------------#######----------------------e---e---------#--------
-------------------------###oo-------------------###----------------e---------------------------------------------------------------------------------------------------------------
--------------------------------#---------------------------------------------------------------------------------------------------------------------------------------------------
------------------------------------------------------------------------ooooo-------------------------------------------------------------------------------------------------------
--------------------------------------------###-------#####------------#######-------?--------------####---###-------###----------------------------------------------#-------------
------------------------------------------------------------------------------------------------------------------------------------------------------------------------------------
------------------------------------------------------------------------------------------------------------------------------------------------------------------------------------
---------------------------------------------------------------------------------------------------------------------------------------e--------------------------------------------
###########--------####------------------------------------------------------###-###--------######-------------------------################---------##############------------------
