------------------------------------------------------------------------------------------------------------------------------------------------------------------------------------
------------------------------------------------------------------------------------------------------------------------------------------------------------------------------------
------------------------------------------------------------------------------------------------------------------------------------------------------------------------------------
------------------------------------------------------------------------------------------------------------------------------------------------------------------------------------
------------------------------------------------------------------------------------------------------------------------------------------------------------------------------------
-----------------e--------------------------------e-----------ooo---------------------------e---------------------------------------------------------------------------------------
--------------BBBBBBBBBBB------------???????---------BBBBBBBBBBBB----BBBBBBBBBBBB#--------------e-----------------------?------------------------------------------------##---------
---------------------------------------------------------------------------------#------e-------------------------------e-----------------------------------------------###---------
---------------------------------------------------------------------------------#-----------------------------------------e-------------------------------------------####---------
-------------------e----------------------------------------e--------------------#--e-------------------------------------e---------e--ee-----------------------------#####---------
--------------BBBBB?BBBBB-----????---B---------------------e-------B------------?#-e--------------------???---------------pP-------e---e----------e------------------######---------
-----------------------------------------------------------pP----------------e---#-pP-----------------------------B-------pP---e---pP--pP---------------------------#######---------
-----------------------------------------------------------pP---------------e----#-pP----------------B------------b-------pP---pP--pP--pP--------------------------########---------
--------------------------------------ee-------------------pP---------------pP---#-pP-e--------------b-e-e--------B-------pP---pP--pP--pP-------------------------#########--------#
#########################----############--------#################----------##################---###########################---##--################----###----##################---#
#########################----############--------#################----------##################---###########################---##--################----###----##################---#
