--------------------------------------------------------------------------------------------------------------------------------------------------------------------------------------------------------------------------------------------------------------------
--------------------------------------------------------------------------------------------------------------------------------------------------------------------------------------------------------------------------------------------------------------------
---------------------e--------------------------------------------------------------------------e-------------------------------------------------------------------------------------------------------------------e-----------------------------------------------
--------------------o?o--------------------------e----------o?o---------------o-------------?B?B?---------------------------------------------------------------o-o-------------------------------------------------?B?B?-------------------------------------------
------------------------------------------------------------------------------------------------------------------ooo---------------e---------e-----------e------------------------e------------------------------------------------------ooo-------------------e---
----------------o-o--------------o---------------------------------------o---------o-----------------------------------------------------------------------------------------------?------------BBB--------o----------------------------------------------------o-o-
-------------------------------------e----e-----------------------------------------------------e------------------------------------------------------------e------------------------------------------------------------------------------------------------------
---------------########--------------##########################--------------###---o------#########-###-----------------########################################-------------------------------------------o------#########-###--------------------------------#####
-------------------------------------------------------------------------e-------------------------------------------###----------------------------------------------------------------------------------------------------------------BBB--###--------------------
------------------------------#######---------------------------------#######------o----------------------------------------------------------------------------------------------###----------------------o-----e--------------------------------------------------
-----##-----------------------------------------------------------e--------------------#####-------------BBB---------------------------------------------------------------------#####-------------------------#####---------------------------------##-------------
-----##---######-------#######---------------------------------#######-------------------------#-#-?----------------------------------------------------------------------------#######----------------------------------#-?-------------------------##---######----
---#-##----------------------------------------------------#-------------------------------------#-----------------------------------------#-------------------#---------------########----------------------------------#-------------------------#-##-------------
---#-##----------------------------------------------------#----------------------------------------------#--------------------------------#-------------------#--------------#########-#--BBB------------------------------------#----------------#-##-------------
--########-------------------------------------------------#-----------------------#####-------#####------#----BBB-------------------------#-------------------#--#######----##########-##-----------------#####-------#####------#---------------########----------
--########-----------------------------------#------------------------------------------------------------#-#----------------#-------------------#--------------------------###########-###----------BBB--------------------------#-#-------------########----------
