----------------------------------------------------------------------------------------------------------------------------------------------------------------------------
----------------------------------------------------------------------------------------------------------------------------------------------------------------------------
----------------------------------------------------------------------------------------------------------------------------------------------------------------------------
----------------------------------------------------------------------------------------------------------------------------------------------------------------------------
----------------------------------------------------------------------------------------------------------------------------------------------------------------------------
---------------------------------------------------------------------------??---------------------------------oooo----------------###---------------------------###---------
------------------------------------------------------------e---------------------------------------------------------------------------------------------------------------
---------------------------------------------e----------------------------------------------------------------------e-------------------------------------------------------
--------------------------------------------------------------------------??----------------------------------------------------------------e-------------------------------
--------------------ee-e----------------------------------------------------------------------------#######-----------------####-----------------ooooooooo--###-------------
-------####################---------############--------------########---------------------------------------##--##--##----------------##-----------------------------------
------#####---------------#---------#----------#-----------------------------------e-----------------------------------------------------------------e----------------------
-----######---------------#--####---#----------#-##########--------------################---------------------------------------------------##############------------------
###########---------------#---------#----------#-#--------#--------------#--------------#--########-----------------------------------------#------------#-------------#####
