----------------------------------------------------------------------------------------------------------------------------------------------------------------------------------------------------------------------------------------------------
----------------------------------------------------------------------------------------------------------------------------------------------------------------------------------------------------------------------------------------------------
------------------------------------------------------------------------------------------------------------------------------------------------------------------------------------------------------------------------####------------------------
-------------------------------------------------------------------------------------------------------------------------------------------------------------------------------------------------------------------------pP-------------------------
-------------------------------------------------------------------------------------------------------------------------------------------------------------------------------------------------------------------------pP---------e---------------
--------------------------------------------------------------------------e-------------------##------------------------???-????????-????-----------#--------------------------------------------------------------------e---------e----------------
------------#--e#--------------------------------------------------------e--------------------pP--------------------------------------pP-----------##----##------##---------------------------------------------------------------#pP---------------
------------#---#--------------------------------------------------------pP-------------------pP--------------------------------------pP----------#####-------------------------------------------------------------------e------##pP---------------
------#---#-#---#--------#-ee----#-------------ooo----------------e------pP-------------------pP--------------------------------------pP---------####---------------------------------------------------------------------------e##pP---------------
------#BBB#-#BB?#--------#BBBBBBB#-------------ooo----------------------BpP-------------------e-BBBBBB--------------------BBBBBBBBBBB-e---------#####-----------------------##-------------------------------------------------e-##pP------------B--
--------------------------------------------------------------oo---------pP------------#-------------------------------------------------------######----------------------###-------------------------------e--------------e-#pP##pP---------------
--------------------------------------------------------------oo---------pP------------##------e-------------------------e---e---------e------#######-e-------------------####------------------------------e---------------e##pP##pP----------BB-BB
-------------------------------------------------------------------------pP------B-----####------e-------------------------------------e-----########e-------------------#####------------------e-----------pP-------------pP##pP##pP--------#-BB-BB
######################--############ee#e###############ee#e#######################-----#########e-#####################################e-############pP------------------######################e------------###########----pP######################-
######################--##########################################################-----#########pP####################################pP-############pP------------------######################pP----##-----###########----pP######################-
