---------------------------------------------------------------------------------------------------------------------------------------------------------------------
---------------------------------------------------------------------------------------------------------------------------------------------------------------------
---------------------------------------------------------------------------------------------------------------------------------------------------------------------
---------------------------------------------------------------------------------------------------------------------------------------------------------------------
-----------------------------------oooo--------------------------------ooooo-----------------------------------------------------------------------------------------
--------------------------###-----######e-----------------------------#######------------------###------######---?------------------###------------------###---------
--------------------###-----------------------------------e------------------------###-----------------------------------------------------------####----------------
------------------------------------------------------------------------------------------------------------------------------###------------------------------------
----------------o------------------------------------------------------------------o-o----------------------------------o-oo-----------------------------------------
---------------###--------###-----------------------------------###----------------o-o-###----------##-------###e#-----###e##----------------------------------------
------------------------------------------------------------##-----------------------------------------------------------------------------###-----------------------
---------------------------------------------------------------------------------------------------------------------------------------------------------------------
-----------------------------------------####e##e#----###-----------------------------------------------------------------------------------------------------------#
###########--------------------------------------------------------------------------------##e####------------------------------------------------------------#######
###########---------------------------------------------------------------------------------------------------------------------------------------------------#######
