---------------------------------------------------------------------------------------------------------------------------------------------------------------------------------------------------------------------------------------------------------------------------------------------------------------------------------------------------------------------------
---------------------------------------------------------------------------------------------------------------------------------------------------------------------------------------------------------------------------------------------------------------------------------------------------------------------------------------------------------------------------
--------------------------------------------------------------------------------------------------------------------------------------------------------------------------------------------------------------------------------------------------------------------------------------------------------------------------------##############################-------------
--B-----------------------------------------------------------------------------------------------------------------------------------------------------------------------------------------------------------------------------------------------------------------------------------------------------------------------------##############################-------------
-------------------------------------------------------------------------------------------------------------------------------------------------------------------------------------------------------------------------------------------------------------------------------------------------------------e------------------##############################-------------
BB-BB---------------------####----------################--------------------------------------------------------------------------##--------###--------####---------##----------------------####------------------------------------------------------------------------------------------##---------e-BBBBB------------------B-##############################-------------
BB-BB----------------------------------------------------------------------------------------------------------------------------###--------###--------####---------##-------------------------------------------------------------------------------------------------------------------###------e-----------------------------##############################-------------
--------------------------------------------------------------------------------------------------------------------------------####--------###--------####---------##------------------------------------------------------------------------------------------------------------------####------------------------------------##############################-------------
B-B-BBB------------------------------------------------------------------------------------------------------------------------#####--------###--------####---------##-----------------------------------------------------------------------------------------------------------------#####---------------------------------B--##############################-------------
B-B-BBB-----????--------------------------------------------------------------------------------------------------------------######B-------###--------####---------##--------------------------------------------------------------------ooo-----------------------------------------######------------BBB---------------------##############################-------------
BBBBBBB-------------------------------------------------------------------B-------------------e------------------------------#######--------###--------####---------##----------------------------------------------------------------------------------------------------------------######-------------------------------e----##############################-------------
-B-B-BB------------------------------------------------------------------beb------------------------------------------------########--------###--------####---------##---------------B---------------------------e--------------------------------------------------------------------######----------------------------------e-##############################-------------
-B-B-BB-------------------------------------------------------e-----------Bee---------------------------e-ee---------------#########--------###--------####---------##---------------b------------------------------------------ee-------------------ee-e------------------ee---#-----######------------------------------------##############################-----------#-
################################-----#########--##--##--##############################################################################------###--------####---------#########---#####################--##--########--########################--##########################--######-----######----------########################################################--###########  
