----------------------------------------------------------------------------------------------------------------------------------------------------------------------------
----------------------------------------------------------------------------------------------------------------------------------------------------------------------------
B-----BBBBBBBBBBBBBBBBBBBBBBBBB?BBBBBBBBBBBBB-------------BB????BBBBBBBBBBBBBBBBBBBBBBBBBBBBBBBBB----BBBBBBBBBBBBBBBBBBBBBBBBBBBBBBBB-----BBBBBBBBBBBBBBBB-------------BBB--
B---------------------------------------BBBBB-----------BB-------------------------------------------BBBB---------------------------------BBBB------------------------------
B---------------------------------------BBBBB--------BBB---------------------------------------------BBBB---------------------------------BBBB------------------------------
B---------------------------------------BBBBB--------------------------------------------------------BBBB----e----------------------------BBBB------------------------------
B---------------------------------------BBBBB---------------------------------------------------------------e---------------------------------------------------------------
B---------------------------------------BBBBB-------B-------------------------------------------------------pP------------e----------------------------------###------------
B--------------------------#####-----e--BBBBB-----e-------#####---------------------------###----------e----pP-----------e-----------------o--------------------------------
B-------------------------######----e------BB----e-------######-------------------###-----------------e---?BBB---e-------pP---------------B?BB---------###------------------
B--------------e---------#######----pP-----BB----pP-----#######-----------###-------------------------pP--------e--------pP--e-----e------BBB-------------------BBB-B--BBBBB
B-----------------------########----pP-----BB----pP----########---###---------------------------------pP--------pP---e---pP--pP----e------BB--------------------BBB-B--BBBBB
B---------------#-----##########----pP-----ee----pP---#########---------------------------------------pP--------pP---pP--pP--pP----pP-------e-ee---#------------BBB-B--BBBBB
#################-----##########--##############################---------------------------------##########----###---##--##--##--###########-#######---------###BBB-B--#####
