---------------------------------------------------------------------------------------------------------------------------------------------------------------------------------------
---------------------------------------------------------------------------------------------------------------------------------------------------------------------------------------
-----------------------------------------------------oooooooo--e------------------e----------------------------------------------------------------------------------------------------
------------#BBBBB---------------------------------BBBBBBBBBBBBBB---BBBB-BBBBBBBBBBBBB----------------------------------BBBBBB-----------------e-----------------------------##--------
------------#----------------------------------------------------e----------------------------------------------------e-----------------------e-----------------------------###--------
------------#---------------------------------------------------------------------------------------------------------------------------------pP---------------------------####--------
-----------e#--e-#-----------------e--?-------------------------------------------e------#-----------------------------e------------------e---pP--------------------------#####--------
------------#BB?B#---?????--------e------------------?BBBBBBBBBB--#?--------------???????#----------------------------e----e-------------e---????------------------------######--------
----------------------------------pP-----------------------------##---------------------------------------------------pP---pP------------pP--------------------e--------#######--------
----------------------------------pP----------------------------###---------------------------------------------------pP---pP------------pP-------------------e--------########--------
----------------------------e-----pP-----e-e---------------e---####-----------#---ee-------------ee-----------ee-e----pP---pP------------pP------e--------e---pP----e-#########--------
###########################e-###########e-######---####################-------##################--######################---##--#############-----#---##################################
