---------------------------------------------------------------------------------------------------------------------------------------------------------------------------------------------------------------------------------
---------------------------------------------------------------------------------------------------------------------------------------------------------------------------------------------------------------------------------
---------------------------------------------------------------------------------------------?---------------------------------------------------------------------------------------------B-------------------------------------
---------------------------------------------------------------------------------------------------------------------------------------------------------------------------------------------------------------------------------
---------------------------------------------------------------------------------------------------------------------------------------------------------------------------------------------------------------------------------
---------------------------------?-?-?----------------BBB-----------------------------------B----------------------------------BBBBBBB---------------------------------------------------####--------------------------###-------
-----------------------------------------------------------------------------------------------------------------------------------------------------------------------------------------###----------------e---------#e##-------
---------------------------------------e---e--------------########---------------------------------------------------------------------------------------------------------------------------------------------------e####-------
---------------------------------------------------------########-------------------------------------------------------------------------------------------------------e---e---------------------------------------e#####-------
-----------------------------e---e--e---#######---------####----------------------------#######-----------------------------------BBBBB------????------------------------------------------------------------------#######-------
---------------##################e######---------------#####--------------------------------------------------------------------e-----------------------------###---###----###----###----------------e------------########-------
--------------###-------------------------------------######----------------e----------------------------####-------------------pP-------------e--------------##----##-----##-----##-----------------------------#########-------
-------------###-------------------------------------######----e-----e------pP-----e-------------------------------------##-----pP-------------------------#----------------------------##----------------------##########-------
################-------------------------------------######----pP-----pP----pP-----pP------------###-----------###-------###################################----------------------------#########################################
################-------------------------------------######----pP-----pP----pP-----pP------------------------------------###################################----------------------------#########################################
