----------------------------------------------------------------------------------------------------------------------------------------------------------------
----------------------------------------------------------------------------------------------------------------------------------------------------------------
-----------------------------------------ooo--------------------------------------------------------------------------------------------------------------------
-----------------------------------------o-o---------------------------?----------------------------------------------------------------------------------------
-------------------------------------------------------------------------------------------ooo---------------------ooooooooo------------------------------------
-----------------------------------------###-----------------------------------------------###-------------------#############----------------------------------
-------------------oooo----------------------------------------------###--ooo-----------------------------------------------------------------------------------
-------------------oo-o---------------------------------------------------ooo---------------------------------------------------e------------------------e------
------------------------------------------------oooo-----------------------------------------------e------------------------------####--------------------------
----------------------################----------oooo-----------############-----------####-----################-------------------------------------------------
-------------------------------------------------------------------------------------------------------------------------------------------#####----------------
------------#######---------------------------#############-----------------------------------------------------------------------------------------------------
------------------------------------------------------------------------------------------------------------------------------------------------------------#---
###########-----------------------------------------------------------------#########---------------------------------------------------------------############
----------------------------------------------------------------------------------------------------------------------------------------------------############
