##--############################----######--################o-o-o-o------------#-----------####---##o-o-o-o------------#--#----------#######-----------####---##############----####--#----------#######----------------------------------------##--####################################-----------
##--############################----######--#######################e-----------##---------#####---#########e-----------#--#---------#########---------#####---##############----####--#---------########----------------------------------------##--####################################-----------
##--###--################--##-#-----#---##--###--###########--#####pP----------##---------#-###---##-######pP----------#--#---------######-##---------#-###---#######---#-#-----#-#---#---------######-#----------------------------------------##--###--###############-###########---------------
##---#---############---#---#------#--e-##---#---###########e------##----------##------------------#-------##----------#------------#-------#------------------##---#-e-#-----------------------#-----------------------------------------------##---#---###########-#----##---###-----------------
##---#---#########-#--------#-----------##---#---#########-#-------##----------#------------e--------------##----------#----------------e-------------------------------#-----------------------------------------------------------------------##---#---#########-#------#----##------------------
-#---#----#----#---#-----e---------------#---#----#----#---#--------------------e----------------------------------------------------------------------------------------------------------------------------------------------------------------#---#---------#---#-------------------------------
---------------#-----------------------------------e-e-#------------------------------------------------------o-o-o-------------------------e------------------e-----------------------------------------------------------------------------------------e-----#-----------------------------------
--------------------------------?S?----------------------------------------------------------------?-----------------------------------------------------------?------------?S?------------------------------------------------------------------------------------------------------###--------###
-------------------------------------------------------------------------------------------------------------------------------------e-------------------------------------------------------------------##------------------##-----------------------------------------BBB----------###--------###
-------------------------------------------------------------------------e----------------oooo-------------------#-------------------------------------ooo----------#-----------------------------e------##------------------##------------------------------------------------------###--------###
----------------------------------------------------------------------B?B?B-----------------------------------?B?B?---------e---------##--##------------------------#-----------------------------##--##-##------------------##-------------------------#--------------------------BB-##---------#-
------------------e---e---------?S?-----------------------e-----##------------------------####----##----##----------------##########--##--##----------####----##---e--------?S?-------##########--##--##-##eeeeeeeeeeee------##eeeeeeeeeeee-------------#-e-------e-------------e-----#------------
-------e----------pP---pP-----------------------e---------pP----##--------------------------------------##----------------##########---#--##-----------------------pP-----------------##########---#--##-##############------##############------------e----------pP----------####----#------------
-------pP---------pP---pP-----------##------e--pP---------pP-------------------#---------------------------------------#-----#-##--#-------#----e------------------pP-----------##-------#-##--#-------#-##############------##############------------pP---------pP----------#-##-----------------
##--########################--------######--##################-------########--####-#####-----------##-------########--#-------#-----------####-#####-----------########--------####-------#-----------#----------------------------------------##--###################----------------------------
##--######################################--##################-------########--####-#####-----------##-------########--#--------------------###-#####-----------####################------------------------------------------------------------##--###################----------------------------
