---------------------------------------------------------------------------------------------------------------------------------------------------------------------------------------------------------------------
---------------------------------------------------------------------------------------------------------------------------------------------------------------------------------------------------------------------
---------------------------------------------------------------------------------------------------------------------------------------------------------------------------------------------------------------------
--------------------------------ooo------------------------------------------------?-----------------------------------------------------------------------------------------------------------e--###----###------e--
--------------------------------ooo----------------------------------------------------------------------------------------------------------------------------------------------------------------------------------
-----------------------------------------------------------------------------------e---------------------------------------------------------------------------------------------------------------------------------
-------------------oooo--------------------------------------------------------------------------------oooo----oooo---------------------------------------------------------------oooo---------#---------------------
-------------------oooo--------------------------------------------------------------------------------oooo----oooo------------B-------###----------------e-----------------------oooo-------------------------------
-------##--#-----------------e-----######e##------------e-----------###-------##-----------------------e------------------------------------------------###-----------###---##----------###--------------------------
------###--#-----------------------#-------#------------------------------------------------------------------------------------------------------------------------------------------------------------------------
-----####--#----###############----#-------#---################-----------##---------###-----###e###########e#########------------------------###---##---------###--------------#######-----------------------------#
#########--#----#-------------#----#-------#---#--------------#------------------------------#-------#---------------#-----######e----------------------------------------------#-----------------------------------#
#########--#----#-------------#----#-------#---#--------------#------------------------------#-------#---------------#----------------------------------------------------------#-----------------------------------#
