-------------------------------------------------------------------------------------------------------------------------------------------------------------------------------------------------
-------------------------------------------------------------------------------------------------------------------------------------------------------------------------------------------------
-------------------------------------------------------------------------------------------------------------------------------------------------------------------------------------------------
-------------------------------------------------------------------------------------------------------------------------------------------------------------------------------------------------
-------------------------------------------------------------------------------------------------------------------------------------------------------------------------------------------------
--------------------------------------------------------------------------------------------------------------------------------------------------e-e-e------------B------------------#B---------
---------------------------------------------------------------------------------------------------#---------------------------------------------e-e-e-------------------------------e#----------
--------------------------------------------------------------------------------------------------##--------------------e------------------------pPpPpP-----------------------------###----------
----------------------------B--------------------------------------------------------------------###-------------------e---------------------??--??????-------------------e--------####B---------
----------------------------------------------e-------------------------------------------------####---------------???-pP---------------------------------------?--------e--------#####----------
--------------------e---------------#---------pP-------???????---------------------------------#####-------------------pP------------------------------------e------e----pP------######----------
-------------------e--------B-------#---------pP----------------------------------------------######-------------------pP-----------------------------------e-------pP---pP-----#######----------
-------------------pP----e--B-------#---------pP-------------------#-----#-----#-------------#######--------------#----pP-----------------------------------pP------pP---pP----########---------#
########################e-##########################################-----#-----################################################################--##############-###-##--#####-#################-#
########################pP##########################################-----#-----################################################################--##############-###-##--#####-#################-#
