----------------------------------------------------------------------------------------------------------------------------------------------------------------------------------------------------------------------------------------------------------------------------------------
----------------------------------------------------------------------------------------------------------------------------------------------------------------------------------------------------------------------------------------------------------------------------------------
--------------------------------------------------------------------------------------------------------------------------------??------------------------------------------------------------------------------------------------------------------------------------------------##----
---------------------------------------------------------------------------------------o-----------------------------------------------------------------------------------------------------------------------------------------------------------------------------------------###-o--
---------------------------------------------------------------------------------e-----o----------------------------------------------------------------------------------------------------------------------------------------------------------------------------------------####----
--------------------------------------------------------------------------------BBBBBB-o-------e-------------------------------------------------------------------------------------------------------------------------------------------------------------------------------#####-o--
----------------------------------?-------------------------------------------e--------o-------?------------------------------??????------------------------------------------?---------------------------------------?-------------------------------------------------------######----
-------------------------------------------------------------------?B?B?------e--------o---------------------------------------------------------------------------------------------------?B?B?------e----------------------------------------------------------BBB---------#######-o--
----------------------e-------------------------------------------------------pP-------o--------------------------------------------------------------------------------------------------------------pP----------------------------------------------------------------------o-o-o-----
-----?----------------?----------------------?--------------------------------pP-------o-----------------?---------------------------------------?----------------?-----------------------------------pP--?----------------------?-----------------------------------------#########-o--
---------------------------------------------------------------e--------------pP--?-----------BBB---------------------------##########----------------------------------------e--------e--------------pP------------------------------------------------------------------##########----
-------------------------------#--##-------------------------###################-------------------------------------------------------------------------------------------#--##-----###################-----------#--##---------------------------------------######-----o-o-o#####-o--
-e--------#----------------e---#--##-----e--------#----------#------------------#---#----------------e--------#--------------------------#---e--------#----------------e---#--##-----#------------------#------e---#--##-----e--------#----------#--------###########---############----
-pP-----#-#------e---------pP--#--##-----pP-----#-#----------#------------------#-#-#----------------pP-----#-#-e----------------------#-----pP-----#-#----------e-----pP--#--##-----#------------------#-----ep-e-#--##-----pP-----#-#e-----------e------###########--#############----
#############################################################-------------------##########-################################################-#########################################-------------------################################################--############-#################
##########################################################################################-################################################-############################################################################################################--############-#################
