---------------------------------------------------------------------------------------------------------------------------------------------------------------------------------------------------------
---------------------------------------------------------------------------------------------------------------------------------------------------------------------------------------------------------
-----------------------------------------------------------------------------------------------------------------------------------------------------------------------------------------------e---------
---------------------------------------------------------------------------------------------------------------------------------------------------------------------------------------------------------
-----------------------------------------------------------e---------------------------------------------------------------------------------------------------------------------------------------------
-------------------------------------------------------BBBBBBBBBB-------------------------------------------------------------------------------------------------------------------------------##-------
---------------------------------------------------------------------------------------------------------------------------------------------------------------------------------------------------------
---------------------------------------------------------------------------------------------------------------------------------------------------------------------------------------------------------
--------------------B--------------------------------------------------#----------------------------------------e--------------------------------------------------------e---------------#---#-----------
------------B-------b------------------------------------------BBBBBBBB#----------------------------------------pP----?????????-------------------------------------???????-----------#------------------
------------b--?-B------???-------------------------------#-----------------------------------------------------pP-------------------------------------#############------------------#------------------
------------B----b----------------------------------------#-----------------------------------------------------pP----B------------------?------------------------------------e-------#------------------
------------b----B----------------------------------------#-------------------e---------e-e-------------e-e-----pP----b-e-----B------e------------e---------------------------pP------#--------#---------
########################################--#######--#-#######################################################################-############-#############################-e-e---#########----#####---------
