-----------------------------------------------------------------------------------------------------------------------------------------------------------------------------------------------------------------------------------------------------------------
-----------------------------------------------------------------------------------------------------------------------------------------------------------------------------------------------------------------------------------------------------------------
------------------------------------------------------------------------------------------------------------------------------------------------------------------------------------------e----------------------------------------------------------------------
-----------------------------------------------------------------------------------------------------------------------------------------------------------------------------------------e-----------------------------------------------------------------------
-----------------------------------------------------------------------------------------------------------------------------------------------------------------------------------------pP----------------------------------------------------------------------
------------------------------------------------------------------------------------------------------------------------------------------------------------------------?-----------B----##-----------------------------------------------------------e##--------
------------------------------------------------------------------------------------------------------------------------B--------------------------oooo----------------------------------------------------------------------------------------------e###--------
--------------------------------------------------------------------------------------------oooooo-------------------------------------------------------------------------------------------------------------------------------------e------------e####--------
-----------e------------------------ooo--------------------oooo-------------------------------------------------------------------------ooo-----------------------------o------------B-------------------oo-----------------------------###------#--#####--------
---------------e-----------------------------------e----------------e------------##----------------------------------------------------------------------------------e--B--------------------------------------------------------------------------######--------
--------------e-----------------------------------e--------------------e---------###-------------------------e------------------------------------------------------e----------------------------------------#-------e----------------------------#######--------
--------------pP-----------------------------#----pP-----------------------------####-------e---------------------------#-------------------------------------------pP---#----e------------------#-----------#------e----------------------------########--------
--------------pP---e--------e---ee-e---------##---pP------ee----------------#----#####-----e------##---ee-----------#---#-------e--ee-e-----ee-----------e-ee-------pPe--#----pP---e-------------#----ee-----#------pP-----e-----ee-------------#########--------
#####################e-####e-###########-----###--pP#########################----######----pP------##################---#--###############################################----#########----------#####################--###############--------##################
