--------------------------------------------------------------------------------------------------------------------------------------------------------------------------------------------
--------------------------------------------------------------------------------------------------------------------------------------------------------------------------------------------
--------------------------------------------------------------------------------------------------------------------------------------------------------------------------------------------
--------------------------------------------------------------------------------------------------------------------------------------------------------------------------------------------
---------------?----------------------------------------------------BB-------------------BBB----B??-----------BB-----?---------------?B----------------------------------------------##-----
----------------------------------------------------------------------------------------------------------------------?-------------------------------------------------------------###-----
----------------------------------------------------------------------------------------------------------------------------e------------------------------------------------------####-----
----------------------------------------------------------------------------------------------------------------------------e-----------------------------------------------------#####-----
-------------?BB?B------------##-----------###---------------------------pPB-----------pP--------B------##B----------?pP------------------------------------------B?-B------------######-------
-----------------------------###---------#####------------pP-----pP-pP----pPpPpP-----------#pP---------------#-----pPpP----pP-pP---------pP--------pPpP--------#pP--------------------pP-----#######--------
------------------------##--####-------######-------------pP-----pP-pP----pPpPpP----------##pP-----------###-------pPpP----pP-pP---------pP--------pPpP---------pP--------------------pP-########-----------
--------------e--------###--#####----########-------------pP-----pP-pP----pPpPpP----e-----##pP---eee-----###-------pPpP----pP-pP---#-----pP--------pPpP---------pP--------------ee----pP#########-----------
###################################################################-########################################################################################################################