----------------------------------------------------------------------------------------------
----------------------------------------------------------------------------------------------
----------------------------------------------------------------------------------------------
----------------------------------------------------------------------------------------------
---------------------------------------------------------------------------------------##-----
--------------------------------------------------------------------------------------###-----
-------------------------------------------------------------------------------------####-----
------------------------------------------------------------------------------------#####-----
---------?---B-B?B-----------------------------###--#------------BB-B------------######-------
---------------------pP------####-------##-----###--##-----pP--------------pP-----#######--------
---------------------pP--########-----####-######--###-----pP--------------pP-########-----------
--------------e------pP-##########----###########--####----pP--------ee----pP#########-----------
####################################################--########################################